F . . # . . . # . . . . # . . . # . . .
. # . . # . . # . . # . . # . . # . . #
. # . . . # . . # . . # . . # . . # . .
. . # # . . . # . . . # . . . # . . . .
. # . . . # . . . # . . # . . . # . # .
. # . . # . . . # . . . # . . # . . # .
. . # . . . # # . . # . . # . . . # # .
# . . # . . . . # . . # . . # . . . # .
. . . . # . . . . # . . # . . . # . . .
. # . . . # # # . # . . . # . . . . # .
. . # . . . # # . . . # . . # . . . . .
. # . . # . . . # . # # . . # . # . . .
# . . # . . . . # # . # # . . . . # # .
. . . # . . # . . # . . . # . # . . . .
. # # . # . . # . . # . . # # # . . . .
. . # . . # . . . # . # . . . . . # . .
# . . # . . # . . # . . # . # . # . # .
. . . . # . . # . . # . . . # . . . . #
. # # . . . # . # . . . # . . # . # . P
. . . . # . . . # . . . # . . . . # . .